OOOOOOOO
O   OR O
O    B O
O   O  O
OOOOOBSO
    O SO
    OOOO