OOOO OOOO
OS OOO SO
O   B   O
O OOBOO O
O   BR  O
OS OOO  O
OOOO OOOO